11111111111111111111111111111
1HHHHHHC11HHHHH00WWRWWWWWWWC1
1HHHHHH11CHHHHH00WW1JJJJJJJ11
1HHHHHH1222220000WW1OOOOOOOO1
10001110000000000WW1OOOOOOOO1
1000000000000000TWW1OOOOOOOO1
1000PWWWWWWWWWWWWWW1OOOOOOOO1
10000WWWWWWWWWWWWWW1OOOOOOOO1
1HHHHHHHHH00GGHHHHH1OOOOO1111
1HHHHHHHHH00GG222221OOOO10E01
1HH111H00000GGHHHHH1OOOO10001
111111112222GGHHHHH1OOOOOOOO1
10000C1HHHHHGG000000111111111
1HH11111HHHHGGHHHHHHHHHHHHHC1
1HHHHHHHHHHHHHHHHHHHHHHHHHH11
11111111111111111111111111111